# Level configuration file for Unnamed Dungeon Crawler
# Characters:
# x - Wall
# _ - Air
# d[0-9] - Door and key needed to open door (optional)
# [0-9] - Key for a door
# [A-Z] - Entity spawn point
#  - S - Player Spawn
#  - E - Generic Enemy Spawn
# ! - Cheat mode door
xxxxxxxxxxxxxxxxxxxxxxxxxxxxxxxxxxxxxxxxxxxxxxxxxxxxxxxxxxxxxxxxxxxxxxxxxxxxxxxx
x________xx________xx________xx________xx________xx________xx________xx________x
x________xx________xx________xx________xx________xx___1____xx________xx________x
x________xx________xx________xx________xx________xx________xx________xx________x
x________xx________xx________xx________xx________xx_E___E__xx________xx________x
x________xx________xx________xx________xx________xx________xx________xx________x
x________xx________xx________xx________xx________xx________xx________xx________x
x________xx________xx________xx________xx________xx________xx________xx________x
x________xx________xx________xx________xx________xx________xx________xx________x
xxxxxxxxxxxxxxxxxxxxxxxxxxxxxxxxxxxxxxxxxxxxxxxxxxxxxxdxxxxxxxxxxxxxxxxxxxxxxxxx
xxxxxxxxxxxxxxxxxxxxxxxxxxxxxxxxxxxxxxxxxxxxxxxxxxxxxx_xxxxxxxxxxxxxxxxxxxxxxxxx
x________xx________xx________xx___B____xx________xx________xx________xx________x
x________xx___2____xx________xx________xx________xx___E____xx_____E__xx________x
x________xx_____E__xx________xx________xx________xx________xx________xx________x
x________xx________xx________xxE______Exx________xx____________________________x
x________xx________xx________xx________xx________xx________xx________xx________x
x________xx________xx________xx________xx________xx________xx________xx____E___x
x________xx________xx________xx________xx________xx________xx________xx________x
x________xx________xx________xx________xx________xx________xx________xx________x
xxxxxxxxxxxxxxdxxxxxxxxxxxxxxxxxxxddxxxxxxxxxxxxxxxxxxxxxxxxxxxxxxxxxxxxxxx_xxxx
xxxxxxxxxxxxxx_xxxxxxxxxxxxxxxxxxxd1d1xxxxxxxxxxxxxxxxxxxxxxxxxxxxxxxxxxxxxxx_xxxx
x________xx________xx________xx________xx________xx__________________xx________x
x________xx________xx___E____xx________xx________xxExxxxxxxxxxxxxxxx_xx________x
x________xx________xx________xx________xx________xx________xxxxxxxxx_xx________x
x________xx____________________________d2____E_______xxxxxx_xxxxxxxxx___________x
x________xx________xx________xx________xx________xx______x_xxxxxxxxxxxx________x
x________xx___E____xx________xx________xx________xxxxxxx_x___E_______xx________x
x________xx________xx________xx________xx________xx_______xxxxxxxxxx_xx________x
x________xx________xx________xx________xx________xxxxxxxx____________xx________x
xxxxxxxxxxxxxxxxxxxxxxxxxxxxxxxxxx__xxxxxxxxxxxxxxxxxxxxxxxxxxxxxxxxxxxxxxx_xxxx
xxxxxxxxxxxxxxxxxxxxxxxxxxxxxxxxxx__xxxxxxxxxxxxxxxxxxxxxxxxxxxxxxxxxxxxxxx_xxxx
x________xx________xx________xx________xx________xx________xx________xx________x
x________xx________xx____1___xx________xx________xx____E___xx________xx________x
x________xx________xx________xx________xx________xx________xx________xx________x
x________xx________xx_________!___S____xx________xx____________________________x
x________xx________xx________xx________xx________xx_E______xx________xx________x
x________xx________xx________xx________xx________xx________xx________xx________x
x________xx________xx____2___xx________xx________xx____E___xx________xx________x
x________xx________xx________xx________xx________xx________xx________xx________x
xxxxxxxxxxxxxxxxxxxxxxxxxxxxxxxxxxxxxxxxxxxxxxxxxxxxxxxxxxxxxxxxxxxxxxxxxxxxxxxx